Municipio;Nombre;2021;2020;2019;2018;2017;AumentoPoblacion
"""43001""";Aiguamúrcia;960;930;901;893;893;67
"""43002""";Albinyana;2504;2468;2438;2371;2340;164
"""43003""";Albiol, L';515;500;485;464;479;36
"""43004""";Alcanar;9579;9434;9418;9402;9393;186
"""43005""";Alcover;5185;5144;5064;5108;5163;22
"""43904""";Aldea, L';4160;4147;4160;4137;4211;-51
"""43006""";Aldover;911;905;882;838;842;69
"""43007""";Aleixar, L';912;893;873;864;866;46
"""43008""";Alfara de Carles;376;376;377;368;369;7
"""43009""";Alforja;1843;1783;1801;1788;1799;44
"""43010""";Alió;478;458;439;426;408;70
"""43011""";Almoster;1322;1341;1351;1342;1361;-39
"""43012""";Altafulla;5512;5307;5243;5120;5089;423
"""43013""";Ametlla de Mar, L';7131;6866;6787;6801;6887;244
"""43906""";Ampolla, L';3444;3277;3205;3280;3334;110
"""43014""";Amposta;21317;21115;20738;20606;20572;745
"""43016""";Arboç, L';5625;5609;5517;5505;5489;136
"""43015""";Arbolí;126;127;137;116;123;3
"""43017""";Argentera, L';126;117;124;129;135;-9
"""43018""";Arnes;441;444;455;466;459;-18
"""43019""";Ascó;1611;1644;1660;1674;1690;-79
"""43020""";Banyeres del Penedès;3280;3207;3170;3128;3121;159
"""43021""";Barberà de la Conca;472;471;473;476;477;-5
"""43022""";Batea;1879;1901;1890;1898;1938;-59
"""43023""";Bellmunt del Priorat;281;273;280;300;290;-9
"""43024""";Bellvei;2303;2237;2203;2190;2193;110
"""43025""";Benifallet;741;723;739;714;721;20
"""43026""";Benissanet;1129;1140;1161;1142;1172;-43
"""43027""";Bisbal de Falset, La;218;211;216;219;217;1
"""43028""";Bisbal del Penedès, La;3830;3631;3528;3464;3460;370
"""43029""";Blancafort;398;382;389;379;381;17
"""43030""";Bonastre;727;685;688;687;661;66
"""43031""";Borges del Camp, Les;2104;2056;2037;2080;2080;24
"""43032""";Bot;566;554;573;601;609;-43
"""43033""";Botarell;1094;1077;1068;1070;1078;16
"""43034""";Bràfim;695;695;692;673;672;23
"""43035""";Cabacés;312;302;298;305;309;3
"""43036""";Cabra del Camp;1230;1175;1163;1141;1131;99
"""43037""";Calafell;28463;27601;26538;25444;24898;3565
"""43903""";Camarles;3220;3194;3224;3278;3270;-50
"""43038""";Cambrils;35064;34734;33898;33362;32855;2209
"""43907""";Canonja, La;5933;5956;5893;5842;5804;129
"""43039""";Capafonts;125;111;121;96;102;23
"""43040""";Capçanes;394;392;398;398;403;-9
"""43041""";Caseres;226;237;259;235;234;-8
"""43042""";Castellvell del Camp;2873;2828;2857;2868;2849;24
"""43043""";Catllar, El;4740;4557;4451;4344;4251;489
"""43045""";Colldejou;167;168;176;170;170;-3
"""43046""";Conesa;106;100;103;103;111;-5
"""43047""";Constantí;6724;6665;6540;6516;6493;231
"""43048""";Corbera d'Ebre;981;1003;1016;1023;1061;-80
"""43049""";Cornudella de Montsant;965;944;941;964;953;12
"""43050""";Creixell;3912;3758;3642;3526;3465;447
"""43051""";Cunit;14081;13533;12952;12326;12041;2040
"""43901""";Deltebre;11539;11578;11482;11505;11499;40
"""43053""";Duesaigües;234;244;245;237;243;-9
"""43054""";Espluga de Francolí, L';3717;3736;3755;3742;3756;-39
"""43055""";Falset;2724;2735;2834;2807;2820;-96
"""43056""";Fatarella, La;917;926;941;965;980;-63
"""43057""";Febró, La;41;40;40;42;42;-1
"""43058""";Figuera, La;117;114;111;104;102;15
"""43059""";Figuerola del Camp;336;329;320;315;330;6
"""43060""";Flix;3451;3410;3408;3491;3605;-154
"""43061""";Forès;48;43;43;42;45;3
"""43062""";Freginals;391;385;346;369;397;-6
"""43063""";Galera, La;723;736;731;719;719;4
"""43064""";Gandesa;3098;3096;3064;3009;3011;87
"""43065""";Garcia;535;527;527;525;531;4
"""43066""";Garidells, Els;198;190;187;201;194;4
"""43067""";Ginestar;787;764;753;762;777;10
"""43068""";Godall;614;598;575;591;608;6
"""43069""";Gratallops;237;237;229;226;237;0
"""43070""";Guiamets, Els;276;278;270;270;272;4
"""43071""";Horta de Sant Joan;1138;1146;1149;1146;1171;-33
"""43072""";Lloar, El;111;105;107;118;117;-6
"""43073""";Llorac;92;91;100;100;93;-1
"""43074""";Llorenç del Penedès;2381;2395;2393;2327;2302;79
"""43076""";Marçà;612;600;594;599;602;10
"""43075""";Margalef;104;106;97;94;101;3
"""43077""";Mas de Barberans;572;564;578;577;584;-12
"""43078""";Masdenverge;1109;1071;1070;1066;1067;42
"""43079""";Masllorenç;508;505;504;498;496;12
"""43080""";Masó, La;283;280;276;276;281;2
"""43081""";Maspujols;826;823;827;799;791;35
"""43082""";Masroig, El;499;492;497;498;510;-11
"""43083""";Milà, El;191;190;178;183;182;9
"""43084""";Miravet;685;706;691;706;726;-41
"""43085""";Molar, El;298;291;297;281;286;12
"""43086""";Montblanc;7433;7379;7364;7384;7307;126
"""43088""";Montbrió del Camp;2985;2909;2890;2828;2806;179
"""43089""";Montferri;397;403;387;383;388;9
"""43090""";Montmell, El;1730;1582;1512;1437;1405;325
"""43091""";Mont-ral;169;168;162;167;164;5
"""43092""";Mont-roig del Camp;12689;12460;12136;11809;11597;1092
"""43093""";Móra d'Ebre;5585;5695;5690;5642;5625;-40
"""43094""";Móra la Nova;3120;3108;3087;3071;3070;50
"""43095""";Morell, El;3732;3742;3704;3649;3631;101
"""43096""";Morera de Montsant, La;163;159;152;157;158;5
"""43097""";Nou de Gaià, La;616;600;603;570;563;53
"""43098""";Nulles;516;509;492;477;464;52
"""43100""";Pallaresos, Els;4872;4850;4777;4739;4635;237
"""43099""";Palma d'Ebre, La;334;338;340;353;356;-22
"""43101""";Passanant i Belltall;167;155;163;150;149;18
"""43102""";Paüls;563;545;556;561;567;-4
"""43103""";Perafort;1275;1264;1261;1265;1253;22
"""43104""";Perelló, El;2846;2826;2770;2863;2884;-38
"""43105""";Piles, Les;218;210;212;210;216;2
"""43106""";Pinell de Brai, El;998;1008;1017;998;1012;-14
"""43107""";Pira;498;503;493;503;500;-2
"""43108""";Pla de Santa Maria, El;2340;2348;2327;2305;2266;74
"""43109""";Pobla de Mafumet, La;4025;3971;3904;3893;3854;171
"""43110""";Pobla de Massaluca, La;341;317;318;328;335;6
"""43111""";Pobla de Montornès, La;2999;2884;2839;2828;2795;204
"""43112""";Poboleda;328;321;313;335;356;-28
"""43113""";Pont d'Armentera, El;493;488;505;512;501;-8
"""43141""";Pontils;138;122;117;114;118;20
"""43114""";Porrera;428;424;439;441;441;-13
"""43115""";Pradell de la Teixeta;164;158;152;159;163;1
"""43116""";Prades;602;588;589;589;599;3
"""43117""";Prat de Comte;186;177;183;179;181;5
"""43118""";Pratdip;680;726;738;709;718;-38
"""43119""";Puigpelat;1196;1163;1149;1151;1147;49
"""43120""";Querol;544;518;507;521;532;12
"""43121""";Rasquera;846;783;781;787;796;50
"""43122""";Renau;155;162;157;153;153;2
"""43123""";Reus;106084;106168;104373;103477;103123;2961
"""43124""";Riba, La;575;585;585;576;590;-15
"""43125""";Riba-roja d'Ebre;1117;1110;1126;1112;1116;1
"""43126""";Riera de Gaià, La;1737;1742;1744;1701;1704;33
"""43127""";Riudecanyes;1194;1146;1124;1131;1101;93
"""43128""";Riudecols;1225;1189;1180;1186;1165;60
"""43129""";Riudoms;6617;6569;6594;6565;6515;102
"""43130""";Rocafort de Queralt;230;211;225;260;241;-11
"""43131""";Roda de Berà;7127;6785;6567;6461;6354;773
"""43132""";Rodonyà;507;494;490;480;498;9
"""43133""";Roquetes;8159;8079;7973;7961;8084;75
"""43134""";Rourell, El;402;372;366;384;369;33
"""43135""";Salomó;544;549;557;564;545;-1
"""43905""";Salou;28512;28526;27476;26775;26233;2279
"""43136""";Sant Carles de la Ràpita;14931;14953;14789;14611;14902;29
"""43137""";Sant Jaume dels Domenys;2666;2624;2622;2551;2561;105
"""43902""";Sant Jaume d'Enveja;3552;3527;3503;3481;3479;73
"""43138""";Santa Bàrbara;3762;3715;3707;3777;3797;-35
"""43139""";Santa Coloma de Queralt;2702;2672;2673;2697;2695;7
"""43140""";Santa Oliva;3450;3353;3320;3328;3315;135
"""43142""";Sarral;1549;1538;1548;1544;1560;-11
"""43143""";Savallà del Comtat;53;53;58;60;56;-3
"""43144""";Secuita, La;1728;1708;1687;1697;1676;52
"""43145""";Selva del Camp, La;5694;5683;5652;5632;5546;148
"""43146""";Senan;42;44;48;47;49;-7
"""43044""";Sénia, La;5530;5640;5681;5644;5652;-122
"""43147""";Solivella;640;632;633;619;614;26
"""43148""";Tarragona;135436;136496;134515;132299;131507;3929
"""43149""";Tivenys;900;902;899;882;879;21
"""43150""";Tivissa;1639;1619;1602;1639;1677;-38
"""43151""";Torre de Fontaubella, La;128;131;138;137;137;-9
"""43152""";Torre de l'Espanyol, La;598;601;611;628;634;-36
"""43153""";Torredembarra;17057;16567;16184;15992;15726;1331
"""43154""";Torroja del Priorat;141;152;149;148;149;-8
"""43155""";Tortosa;33572;33439;33372;33510;33445;127
"""43156""";Ulldecona;6317;6525;6300;6240;6321;-4
"""43157""";Ulldemolins;400;398;396;402;395;5
"""43158""";Vallclara;91;88;98;98;103;-12
"""43159""";Vallfogona de Riucorb;77;77;91;85;87;-10
"""43160""";Vallmoll;1793;1774;1756;1738;1702;91
"""43161""";Valls;24553;24477;24359;24156;24112;441
"""43162""";Vandellòs i l'Hospitalet de l'Infant;6645;6603;6482;6386;6294;351
"""43163""";Vendrell, El;38891;38373;37606;37153;36568;2323
"""43164""";Vespella de Gaià;458;417;410;410;424;34
"""43165""";Vilabella;705;729;736;746;749;-44
"""43175""";Vilalba dels Arcs;630;621;625;635;643;-13
"""43166""";Vilallonga del Camp;2385;2405;2389;2339;2340;45
"""43168""";Vilanova de Prades;108;107;112;117;121;-13
"""43167""";Vilanova d'Escornalbou;582;565;545;549;521;61
"""43169""";Vilaplana;536;555;574;579;585;-49
"""43170""";Vila-rodona;1299;1276;1255;1253;1259;40
"""43171""";Vila-seca;22522;22555;22187;22107;21993;529
"""43172""";Vilaverd;445;443;452;456;440;5
"""43173""";Vilella Alta, La;131;133;135;132;127;4
"""43174""";Vilella Baixa, La;208;204;202;202;200;8
"""43176""";Vimbodí i Poblet;880;890;892;917;917;-37
"""43177""";Vinebre;427;425;428;432;428;-1
"""43178""";Vinyols i els Arcs;2193;2124;2056;1974;1928;265
"""43052""";Xerta;1159;1154;1170;1170;1188;-29
