Municipio;Nombre;2021;2020;2019;2018;2017;AumentoPoblacion
"""46001""";Ademuz;1027;1037;1042;1046;1073;-46
"""46002""";Ador;1772;1730;1508;1393;1400;372
"""46004""";Agullent;2369;2388;2410;2413;2387;-18
"""46042""";Aielo de Malferit;4592;4625;4618;4646;4706;-114
"""46043""";Aielo de Rugat;160;160;155;155;160;0
"""46005""";Alaquàs;29649;29711;29561;29341;29474;175
"""46006""";Albaida;5975;5914;5900;5908;5946;29
"""46007""";Albal;16646;16577;16399;16270;16244;402
"""46008""";Albalat de la Ribera;3368;3326;3360;3329;3361;7
"""46009""";Albalat dels Sorells;4110;4036;3977;3944;3900;210
"""46010""";Albalat dels Tarongers;1324;1208;1232;1202;1169;155
"""46011""";Alberic;10571;10519;10526;10556;10504;67
"""46012""";Alborache;1283;1229;1160;1127;1140;143
"""46013""";Alboraia/Alboraya;24904;24741;24454;24222;24031;873
"""46014""";Albuixech;4189;4151;4017;3983;3911;278
"""46016""";Alcàntera de Xúquer;1402;1341;1291;1297;1318;84
"""46015""";Alcàsser;10266;10196;10039;9908;9813;453
"""46018""";Alcublas;610;611;628;654;678;-68
"""46020""";Alcúdia de Crespins, l';5144;5113;5157;5188;5108;36
"""46019""";Alcúdia, l';12193;12107;12009;11938;11926;267
"""46021""";Aldaia;32313;32204;31864;31492;31320;993
"""46022""";Alfafar;21415;21395;20890;20763;20776;639
"""46024""";Alfara de la Baronia;590;569;557;539;535;55
"""46025""";Alfara del Patriarca;3301;3282;3310;3314;3348;-47
"""46026""";Alfarp;1564;1571;1544;1532;1517;47
"""46027""";Alfarrasí;1206;1219;1225;1262;1256;-50
"""46023""";Alfauir;467;449;437;440;448;19
"""46028""";Algar de Palancia;499;491;481;470;471;28
"""46029""";Algemesí;27305;27430;27331;27285;27511;-206
"""46030""";Algímia d'Alfara;1079;1053;1011;1019;1051;28
"""46031""";Alginet;13942;13827;13380;13100;13186;756
"""46032""";Almàssera;7433;7438;7349;7295;7308;125
"""46033""";Almiserà;264;265;262;258;261;3
"""46034""";Almoines;2528;2477;2414;2379;2343;185
"""46035""";Almussafes;8984;8979;8967;8932;8914;70
"""46036""";Alpuente;659;635;633;637;644;15
"""46037""";Alqueria de la Comtessa, l';1481;1496;1476;1418;1443;38
"""46017""";Alzira;44865;44938;44352;44393;44255;610
"""46038""";Andilla;315;308;319;303;322;-7
"""46039""";Anna;2627;2615;2628;2638;2639;-12
"""46040""";Antella;1127;1157;1175;1209;1233;-106
"""46041""";Aras de los Olmos;374;359;381;374;375;-1
"""46003""";Atzeneta d'Albaida;1139;1162;1165;1162;1155;-16
"""46044""";Ayora;5215;5283;5312;5276;5311;-96
"""46046""";Barx;1354;1303;1277;1229;1227;127
"""46045""";Barxeta;1604;1586;1601;1604;1577;27
"""46047""";Bèlgida;654;679;673;672;690;-36
"""46048""";Bellreguard;4632;4618;4608;4549;4550;82
"""46049""";Bellús;311;299;304;314;315;-4
"""46050""";Benagéber;184;180;192;190;192;-8
"""46051""";Benaguasil;11369;11256;10988;10878;10960;409
"""46052""";Benavites;653;638;619;594;613;40
"""46053""";Beneixida;639;627;651;648;648;-9
"""46054""";Benetússer;15430;15000;14799;14668;14495;935
"""46055""";Beniarjó;1780;1767;1765;1746;1759;21
"""46056""";Beniatjar;207;219;223;224;219;-12
"""46057""";Benicolet;587;574;569;582;585;2
"""46904""";Benicull de Xúquer;1095;1048;1012;974;970;125
"""46060""";Benifaió;11967;11989;11962;11930;11956;11
"""46059""";Benifairó de la Valldigna;1542;1558;1571;1580;1596;-54
"""46058""";Benifairó de les Valls;2268;2213;2186;2168;2205;63
"""46061""";Beniflá;463;460;457;455;458;5
"""46062""";Benigànim;5742;5779;5841;5899;5850;-108
"""46063""";Benimodo;2253;2272;2268;2241;2230;23
"""46064""";Benimuslem;653;667;653;660;656;-3
"""46065""";Beniparrell;2024;2015;1952;1931;1964;60
"""46066""";Benirredrà;1547;1555;1592;1576;1570;-23
"""46067""";Benissanó;2334;2291;2260;2224;2238;96
"""46068""";Benissoda;441;432;430;418;425;16
"""46069""";Benissuera;183;185;194;180;194;-11
"""46070""";Bétera;25423;24604;24272;23647;23178;2245
"""46071""";Bicorp;527;529;533;524;526;1
"""46072""";Bocairent;4101;4142;4195;4214;4271;-170
"""46073""";Bolbaite;1336;1324;1356;1347;1362;-26
"""46074""";Bonrepòs i Mirambell;3780;3738;3691;3645;3629;151
"""46075""";Bufali;163;156;161;159;163;0
"""46076""";Bugarra;728;739;727;715;711;17
"""46077""";Buñol;9438;9498;9408;9517;9596;-158
"""46078""";Burjassot;38712;38632;38024;37584;37575;1137
"""46079""";Calles;368;355;355;342;345;23
"""46080""";Camporrobles;1204;1198;1191;1195;1217;-13
"""46081""";Canals;13257;13516;13587;13588;13631;-374
"""46082""";Canet d'En Berenguer;6812;6765;6697;6575;6473;339
"""46083""";Carcaixent;20494;20436;20358;20424;20483;11
"""46084""";Càrcer;1822;1827;1862;1876;1923;-101
"""46085""";Carlet;15851;15740;15598;15514;15446;405
"""46086""";Carrícola;102;99;94;93;95;7
"""46087""";Casas Altas;132;131;131;136;139;-7
"""46088""";Casas Bajas;164;163;164;172;172;-8
"""46089""";Casinos;2881;2780;2777;2773;2759;122
"""46257""";Castelló;6996;7054;7049;7095;7209;-213
"""46090""";Castelló de Rugat;2316;2298;2274;2275;2278;38
"""46091""";Castellonet de la Conquesta;139;141;147;145;138;1
"""46092""";Castielfabib;299;308;317;306;311;-12
"""46093""";Catadau;2846;2804;2777;2830;2773;73
"""46094""";Catarroja;28509;28608;28120;27827;27752;757
"""46095""";Caudete de las Fuentes;701;711;700;696;706;-5
"""46096""";Cerdà;345;331;331;334;341;4
"""46107""";Chella;2437;2472;2435;2469;2513;-76
"""46106""";Chelva;1583;1531;1489;1498;1516;67
"""46108""";Chera;490;469;474;494;484;6
"""46109""";Cheste;8871;8735;8494;8319;8372;499
"""46111""";Chiva;15769;15414;15123;14941;14867;902
"""46112""";Chulilla;700;662;665;615;628;72
"""46097""";Cofrentes;1122;1123;1130;1125;1104;18
"""46098""";Corbera;3088;3088;3100;3160;3190;-102
"""46099""";Cortes de Pallás;758;771;814;818;876;-118
"""46100""";Cotes;326;333;333;332;336;-10
"""46105""";Cullera;22708;22521;22145;21918;21999;709
"""46113""";Daimús;3277;3196;3117;3128;3018;259
"""46114""";Domeño;670;673;708;704;689;-19
"""46115""";Dos Aguas;312;327;376;355;379;-67
"""46116""";Eliana, l';18302;18362;18235;18050;17760;542
"""46117""";Emperador;698;688;687;692;707;-9
"""46118""";Enguera;4779;4777;4752;4800;4926;-147
"""46119""";Ènova, l';912;902;887;903;919;-7
"""46120""";Estivella;1491;1441;1456;1432;1416;75
"""46121""";Estubeny;114;125;121;122;119;-5
"""46122""";Faura;3563;3553;3538;3547;3503;60
"""46123""";Favara;2563;2504;2518;2490;2473;90
"""46126""";Foios;7502;7452;7367;7342;7234;268
"""46128""";Font de la Figuera, la;2025;2027;2038;2038;2067;-42
"""46127""";Font d'En Carròs, la;3793;3778;3794;3790;3743;50
"""46124""";Fontanars dels Alforins;959;959;971;979;985;-26
"""46125""";Fortaleny;1011;1020;1026;1030;1033;-22
"""46129""";Fuenterrobles;694;694;682;682;709;-15
"""46131""";Gandia;75970;75798;74562;73829;74121;1849
"""46902""";Gátova;419;405;378;392;398;21
"""46130""";Gavarda;1035;1042;1038;1058;1073;-38
"""46132""";Genovés, el;2785;2778;2842;2828;2815;-30
"""46133""";Gestalgar;541;548;556;554;596;-55
"""46134""";Gilet;3501;3404;3324;3276;3308;193
"""46135""";Godella;13027;13131;13088;13058;13031;-4
"""46136""";Godelleta;3714;3584;3533;3462;3391;323
"""46137""";Granja de la Costera, la;281;295;285;297;312;-31
"""46138""";Guadasséquies;459;456;468;444;459;0
"""46139""";Guadassuar;5938;5902;5893;5914;5913;25
"""46140""";Guardamar de la Safor;547;531;526;491;472;75
"""46141""";Higueruelas;524;501;500;508;503;21
"""46142""";Jalance;795;834;830;845;852;-57
"""46144""";Jarafuel;772;769;754;776;785;-13
"""46154""";Llanera de Ranes;1056;1047;1055;1049;1042;14
"""46155""";Llaurí;1169;1130;1170;1209;1221;-52
"""46147""";Llíria;23648;23482;23253;22972;22793;855
"""46152""";Llocnou de la Corona;124;124;118;118;116;8
"""46153""";Llocnou de Sant Jeroni;557;554;546;542;544;13
"""46151""";Llocnou d'En Fenollet;912;916;916;893;887;25
"""46156""";Llombai;2651;2653;2685;2686;2702;-51
"""46157""";Llosa de Ranes, la;3687;3642;3575;3585;3599;88
"""46150""";Llutxent;2315;2326;2345;2373;2367;-52
"""46148""";Loriguilla;2027;2035;2025;1984;1985;42
"""46149""";Losa del Obispo;531;505;507;504;510;21
"""46158""";Macastre;1338;1300;1283;1240;1236;102
"""46159""";Manises;31287;31240;30919;30693;30630;657
"""46160""";Manuel;2452;2436;2428;2439;2448;4
"""46161""";Marines;1894;1848;1828;1828;1858;36
"""46162""";Massalavés;1632;1610;1596;1575;1596;36
"""46163""";Massalfassar;2574;2555;2469;2480;2462;112
"""46164""";Massamagrell;16132;16163;15952;15752;15553;579
"""46165""";Massanassa;9845;9782;9667;9538;9375;470
"""46166""";Meliana;10926;10970;10822;10662;10678;248
"""46167""";Millares;341;331;345;346;349;-8
"""46168""";Miramar;2740;2685;2634;2599;2608;132
"""46169""";Mislata;44320;44320;43691;43278;43042;1278
"""46170""";Mogente/Moixent;4326;4307;4302;4318;4371;-45
"""46171""";Moncada;21875;22021;21935;21802;21623;252
"""46173""";Montaverner;1630;1635;1630;1631;1666;-36
"""46174""";Montesa;1149;1155;1164;1180;1204;-55
"""46175""";Montitxelvo/Montichelvo;588;585;584;605;614;-26
"""46176""";Montroi/Montroy;3069;2956;2867;2822;2865;204
"""46172""";Montserrat;8655;8188;7878;7583;7419;1236
"""46177""";Museros;6618;6596;6458;6291;6164;454
"""46178""";Nàquera/Náquera;7301;6897;6577;6205;6058;1243
"""46179""";Navarrés;3004;3004;2968;2975;3031;-27
"""46180""";Novelé/Novetlè;853;857;837;838;858;-5
"""46181""";Oliva;25119;25224;25101;25199;25488;-369
"""46183""";Olleria, l';8404;8320;8281;8225;8261;143
"""46182""";Olocau;2028;1828;1771;1766;1750;278
"""46184""";Ontinyent;35946;35761;35347;35395;35342;604
"""46185""";Otos;428;422;434;446;450;-22
"""46186""";Paiporta;26401;26514;26088;25309;25241;1160
"""46187""";Palma de Gandía;1660;1709;1631;1543;1511;149
"""46188""";Palmera;1024;1018;1024;1047;1024;0
"""46189""";Palomar, el;562;567;590;576;579;-17
"""46190""";Paterna;71361;71035;70195;69156;68547;2814
"""46191""";Pedralba;2852;2814;2778;2777;2785;67
"""46192""";Petrés;1012;999;997;969;968;44
"""46193""";Picanya;11692;11606;11513;11409;11278;414
"""46194""";Picassent;21487;21263;20942;20709;20658;829
"""46195""";Piles;2742;2740;2685;2688;2712;30
"""46196""";Pinet;161;157;157;156;159;2
"""46199""";Pobla de Farnals, la;8205;8128;7978;7840;7747;458
"""46202""";Pobla de Vallbona, la;25275;24858;24433;24068;23684;1591
"""46200""";Pobla del Duc, la;2483;2515;2543;2537;2589;-106
"""46203""";Pobla Llarga, la;4440;4452;4452;4482;4493;-53
"""46197""";Polinyà de Xúquer;2495;2503;2472;2459;2484;11
"""46198""";Potries;1065;1060;1046;1014;1013;52
"""46205""";Puçol;19975;19737;19495;19455;19531;444
"""46201""";Puebla de San Miguel;60;61;62;61;62;-2
"""46204""";Puig de Santa Maria, el;8737;8718;8630;8566;8618;119
"""46101""";Quart de les Valls;1050;1024;988;992;1042;8
"""46102""";Quart de Poblet;25035;25062;24760;24536;24491;544
"""46103""";Quartell;1640;1655;1636;1561;1539;101
"""46104""";Quatretonda;2146;2202;2212;2239;2278;-132
"""46206""";Quesa;669;663;670;662;673;-4
"""46207""";Rafelbunyol;9351;9149;8941;8929;8870;481
"""46208""";Rafelcofer;1365;1355;1345;1358;1375;-10
"""46209""";Rafelguaraf;2358;2355;2335;2370;2394;-36
"""46210""";Ráfol de Salem;449;442;462;440;425;24
"""46212""";Real;2250;2207;2154;2152;2184;66
"""46211""";Real de Gandia, el;2551;2531;2461;2395;2363;188
"""46213""";Requena;20235;20405;20254;20227;20320;-85
"""46214""";Riba-roja de Túria;22799;22761;22264;21992;21626;1173
"""46215""";Riola;1780;1790;1759;1734;1785;-5
"""46216""";Rocafort;7445;7314;7240;7160;7004;441
"""46217""";Rotglà i Corberà;1146;1117;1138;1114;1108;38
"""46218""";Ròtova;1271;1293;1294;1262;1259;12
"""46219""";Rugat;180;174;158;162;158;22
"""46220""";Sagunto/Sagunt;67043;67173;66140;65669;65278;1765
"""46221""";Salem;414;418;424;433;437;-23
"""46903""";San Antonio de Benagéber;9501;9286;9089;8846;8755;746
"""46222""";Sant Joanet;519;507;504;486;484;35
"""46223""";Sedaví;10344;10391;10333;10245;10179;165
"""46224""";Segart;177;164;163;158;158;19
"""46225""";Sellent;377;384;389;379;376;1
"""46226""";Sempere;26;30;34;35;41;-15
"""46227""";Senyera;1132;1134;1136;1143;1149;-17
"""46228""";Serra;3326;3187;3124;3091;3068;258
"""46229""";Siete Aguas;1183;1159;1154;1171;1196;-13
"""46230""";Silla;19211;19078;18771;18467;18440;771
"""46231""";Simat de la Valldigna;3286;3297;3329;3325;3297;-11
"""46232""";Sinarcas;1109;1105;1125;1124;1147;-38
"""46233""";Sollana;4911;4881;4861;4884;4886;25
"""46234""";Sot de Chera;387;362;369;352;370;17
"""46235""";Sueca;27617;27566;27479;27460;27598;19
"""46236""";Sumacàrcer;1072;1097;1096;1109;1141;-69
"""46237""";Tavernes Blanques;9205;9224;9120;9117;9095;110
"""46238""";Tavernes de la Valldigna;17162;17254;17201;17158;17336;-174
"""46239""";Teresa de Cofrentes;618;619;636;650;631;-13
"""46240""";Terrateig;276;256;278;280;284;-8
"""46241""";Titaguas;470;454;453;459;450;20
"""46242""";Torrebaja;403;402;411;397;412;-9
"""46243""";Torrella;135;145;146;148;145;-10
"""46244""";Torrent;84025;83962;82208;81245;80630;3395
"""46245""";Torres Torres;672;669;637;640;641;31
"""46246""";Tous;1284;1287;1263;1254;1268;16
"""46247""";Tuéjar;1164;1137;1116;1132;1147;17
"""46248""";Turís;6910;6722;6646;6623;6627;283
"""46249""";Utiel;11478;11458;11531;11540;11601;-123
"""46250""";València;789744;800215;794288;791413;787808;1936
"""46251""";Vallada;3092;3096;3039;3036;3093;-1
"""46252""";Vallanca;136;133;139;126;120;16
"""46253""";Vallés;152;154;157;157;153;-1
"""46254""";Venta del Moro;1194;1198;1207;1242;1277;-83
"""46255""";Vilallonga/Villalonga;4453;4370;4270;4303;4371;82
"""46256""";Vilamarxant;10097;9891;9717;9550;9376;721
"""46258""";Villar del Arzobispo;3578;3536;3554;3579;3542;36
"""46259""";Villargordo del Cabriel;585;582;589;586;612;-27
"""46260""";Vinalesa;3451;3412;3420;3380;3345;106
"""46145""";Xàtiva;29459;29623;29231;29045;29070;389
"""46143""";Xeraco;5771;5720;5655;5702;5715;56
"""46146""";Xeresa;2256;2197;2168;2145;2162;94
"""46110""";Xirivella;30208;30197;29623;29108;28950;1258
"""46261""";Yátova;2112;2079;2067;2073;2080;32
"""46262""";Yesa, La;230;221;229;227;234;-4
"""46263""";Zarra;364;346;359;365;381;-17
